
1111111111111111111111111111
1000000000000000000000000001
1000000000000000000000000001
1000000000000X00000000000001
1000000000000000000000000001
1000000100100100100100000001
1000000000000000000000000001
1000000000000000000000000001
1000000000000000000000000001
1111111111111111111111111111
